19 22
1111111111111111111
1666666661666666661
1711611161611161171
1666666666666666661
1611616111116161161
1666616661666166661
1111611161611161111
1111616666666161111
1111616110116161111
0000666100016660000
1111616100016161111
1111616111116161111
1111616660666161111
1111616111116161111
1666666661666666661
1611611161611161161
1661666666666661661
1161616111116161611
1666616661666166661
1711111161611111171
1666666666666666661
1111111111111111111
